11111111111111111
1P000000000000001
10000111000000001
10000000000000001
10011100001110001
10000000000000001
10000000001110001
10000000C00000001
11100011100000001
1C000000000000001
10000000000000C01
100000000000000E1
11111111111111111

