11111
1PX01
10C01
1C0E1
11111
