11111
1P0001
10C01111
1C0E11
111111111111