1111111111
1P000000C1
1000010001
1000010001
1C00001111
100000E001
10000010C1
1111111111
